WWWWWWWWWW
W  A  S  W
W  C     W
W  XXT   W
W  ROWWWWW
W    W    
W   BW   W
W    W   W
W O      W
WWWWWWWWWW