WWWWWWWWWW
W         
W R      W
WWWW     W
W   S    W
W      b W
W   B WWWW
W        W
W O      W
WWWWWWWWWW