WWWWWWWW W
W   R  W X
  B C    X
W X X X  X
W        W
W  WW  S W
W   W    W
W   WWWWWW
W         
WWWWWWWWWW