WWWWWWWWWW
W     S  W
W        W
W     RC W
W    WWWWW
WK   W    
W   BW   W
W  C W   W
W XO  R  W
WWWWWWWWWW