WWWWWWWWWW
W  A  S  W
W        W
W  XXTC  W
W   OWWWWW
W    W    
W  KBW   W
W    W   W
W X      W
WWWWWWWWWW