WWWWWWWWWWW
W   A     W
  S A   T W
WWWWW     W
W   T   C W
W     A   W
W   WWWTWTW
W   C  WWWW
WY    B   W
WWWWWWWWW W
