WWWWWWWWWW
W  b   S W
W        W
W     RC W
WA   WWWWW
W C  W    
W   BW   W
W  C W   W
W XO  R  W
WWWWWWWWWW