WWWWWWWWWW
WCb   A  W
WR C     W
W SXXT b W
W  O WWWWW
W    W    
W B  W   W
W    W   W
W   b    W
WWWWWWWWWW