WWWWWWWWWW
WCb   A  W
WR C     W
W SXXT b W
W    WWWWW
W    W    
W B  W   W
W    W   W
W  Ab    W
WWWWWWWWWW